超神机械师|齐佩甲|韩萧，《星海》骨灰级代练，被来自东（zuo）方(zhe)的神秘力量扔进穿越大军，携带玩家面板变成NPC，回到《星海》公测之前，毅然选择难度最高的机械系。战舰列队纵横星海，星辰机甲夭矫如龙，幽能炮毁天灭地，还有无边无际的机械..
我只想安心修仙|历史里吹吹风|我只想安心修仙，奈何妖魔祸乱人间。道人骑驴下青山，做世上唯一的仙，敕封天地万物为神。作者自定义标签：穿越..
我在荒岛创造一个文明|金色传说|一场空难，把他带到一座荒岛。他不懂荒野求生，也没有瑞士军刀。开局只有赤手空拳，和一个柔弱的女子。残酷的大自然，卑劣的幸存者，野蛮的原始部落。全都想要我的命？既然无法回到文明，那么我来创造一个文明！..
圣武称尊|小圆源|圣武大陆，武道昌盛。其巅峰处为圣者。时光如浪，淘尽英雄。唯圣者之名，不灭永存。宛如夏夜，万籁俱寂，一颗颗星闪烁，点亮夜空。小小裂岩城内，少年楚天的人生被点亮。自此，他迈向巅峰。武道巅峰是为圣，圣者如星吾独尊..
绝代名师|相思洗红豆|市二中的金牌老师孙默落水后，来到了中州唐国，成了一个刚毕业的实习老师，竟然有了一个白富美的未婚妻，未婚妻竟然还是一所名校的校长，不过这名校衰败了，即将摘牌除名，进行废校处理……孙默的开局，就是要帮助未婚妻坐稳..
重生之绝代仙尊|封情老衲|一代仙尊都市重生，变身快递小哥，开始新一世的开挂人生！..
纵横万道|浅歌|曾经的天才，却受人所害，修为尽无，经脉寸断。离家出走，五年后王者归来。因为一枚无名玉佩，家族尽被屠灭。叶歌心中充满了杀意，踏上了寻仇之路。一路上，为了养活身体中几个大爷，四处搜刮各种资源，资源掠夺海量，每天依然囊..
无敌修仙在校园|山村小伙夫|仙尊重生校园，爆惊天丑闻，被美女偷窥，该如何应对？怎么说呢？这是一个让各位大大爽了又爽欲罢不能的故事！..
崩仙逆道|雨暮浮屠|古老洪荒大陆，埋葬了多少秘密。曾经仙道的文明已经逝去，而如今是科技的横行时代！有强悍天穹战甲，动辄屠神灭魔；有憾世时空要塞，泯灭圣灵妖皇。人族，以科技的文明对抗洪荒大陆诸多强悍种族，无往不利。而他，就是出生在了..
一品修仙|不放心油条|古老的仙道世界，历久弥新，一代代天骄英豪，你方唱罢我登台。正是一个大时代沉寂许久之时，一个穿越而来的少年，在曾经闻名天下，现已废弃多时的壶梁，探出自己的罪恶之手。“我告诉你们，只有一级小号自带的技能，才是最实用..
无上道境|孤独的小野马|天行大陆，强者为尊。上古时期天地大乱，为了拯救苍生，两位人类圣祖创建新的修炼体系，让濒危的人类重生，从此天道诸多修炼方式落寞。在此千万年后，一个山村小子，为了心中的强者之梦，在兄弟朋友，红颜知己的陪伴下踏上了强..
太上执符|第九天命|问苍茫大地，何处容我人族！他从未想过自己来到洪荒神话世界，更不会想到人族面对太古百族如此苟且！直到他看到天空中的十个太阳，并且对着太阳射了一箭！那一年，他以为握住的只是一颗种子，谁知道却是整个世界..
天刑纪|曳光|今朝修仙不为仙，只为春色花满园；来日九星冲牛斗，且看天刑开纪元。PS：纵横仙侠大神曳光新作，推荐阅读..
剑徒之路|惰堕|谁说没有丹药就不能精进？谁说不会炼器就没有神兵？谁说挫于制符就没有战斗力？所谓一剑破万法，在于信心。。。当危险来临，你唯一的依靠只有剑，而不是其他....作品标签：淡定 穿越 略文青 不套路  杀伐果断 智商在线..
焚天剑帝|千骑绝尘|妖孽或是废物只在一线之间，一个落魄身负血仇的少年，自武魂彻底觉醒的那一日起，巧获帝剑，逆天武魂可吞噬万魂凝无上圣体，令神魔俯首，引美人尽折腰！标签：玄幻、扮猪吃虎、升级..
凡人修仙之仙界篇|忘语|凡人修仙，风云再起。时空穿梭，轮回逆转。金仙太乙，大罗道祖。三千大道，法则至尊。《凡人修仙传》仙界篇，一个韩立叱咤仙界的故事，一个凡人小子修仙的不灭传说。特说明下，没有看过前传的书友，并不影响本书的阅读体验，但..
超凡黎明|文抄公|穿越之后才发现，东方有灵气复苏，西方有诸神黎明。蒸汽大炮与神秘的碰撞，西方超凡的渐渐苏醒。【爆破大师】+【蒸汽专家】＝【机械大师】；【咒法师】+【剑士】＝【咒剑士】各种各样的进阶、转职与隐藏职业，还有永无止境..
逍遥刀仙|天刈留香|万世天才，举世修炼，一刀千古传！灵修武修，炼丹盗丹，脚踏天才战！阴界古府，六极秘地，闯天翻地覆！葬情葬义，至寒至热，丹田可吞天！超级体质，踏尽一切天才，逍遥俊秀，敛进美女无数！哥修的不是丹田，而是传说！楚天逸扛着弯刀如是说！..
神御九天|网络黑侠|错失宗门前三席位的外门弟子萧雾，被曾经的竞争对手接连打压两年，蛰伏之际，于阴魂池得到初代掌门遗留的破损法器，无意间揭开针对百鬼门的庞大阴谋面纱。失去的光阴，我要夺回来。辱我的敌人，尸伏于脚下。漫天神佛大能..
纣临|三天两觉|死而以行为谥。残义损善者，谓之纣。然，此恶谥之祖，实是文治武功，一代枭雄。比之无数上谥之庸才，又当如何？若纣为罪，罪当再临。当这第五王国再次腐朽之时，逆十字的旗帜自当再现。那旗下之恶才、罪徒……亦将再次掀起一..
万古战尊|寂寞观鱼|白牧尘，曾被称作星空下第一天才，拥有世所罕见的天灵五脉。他曾拥有最显赫的身份，被看做数千年来最有希望登顶武道之人。他曾拥有最美丽的未婚妻子，集万千宠爱于一身。而这一切，都从一场背叛，而划上了句号..
真龙|青狐妖|以遗族的视角看世界，发现一切都变了：儒家经文、道家符咒、佛家手印，统统暗藏玄机；冻龄御姐、凶萌萝莉、二货青年，个个都是大佬。觉醒真龙血脉之后，新时代大学生秦尧觉得一切都那么不科学，但又……贼爽！..
太古神帝|未知明天|列位少年王的姬阳，遭同族陷害，落魄为三灾门杂役弟子。少年壮志，怎能就此认命？历经磨难，终得太古人龙传承。修太古神术，血脉升级，终化神龙！这一世，辱我之人，我必诛之。这一世，负我之人，我必灭之。这一世，人龙觉醒，我为太古神..
长生天|余庆|那一年，他以八岁讲道而闻名天下，那一年，他以面向众生而只身背剑上魔山，那一年，天道陨落，他以背向众生上青天，世间哪有那么多天妒英才，他不就是那个一直名震山河的人？..
圣龙图腾|风青阳|起源大陆，众生于九岁开始，便可沟通‘起源神柱’，得‘本命图腾’，开启武道通神之路。凡人以诸天古神为信仰，于肉身开辟武道图腾，修圣体，开神印，有朝一日，便能破天璧，入神国，永生不死。少年丧魂之日，圣龙图腾加身！诸天万界，龙..
血染长生|夜开花|法不孤起，仗境方生；道不虚行，遇缘则应。三度轮回，只为重归故土，夺回那已蒙尘多年的无上荣耀。苦练七十二绝技，只为征战三界，踏血问仙，令苍生俯首，我自逍遥....
天道图书馆|横扫天涯|张悬穿越异界，成了一名光荣的教师，脑海中多出了一个神秘的图书馆。只要他看过的东西，无论人还是物，都能自动形成书籍，记录下对方各种各样的缺点，于是，他牛大了！教学生、收徒弟，开堂授课，培育最强者，传授天下..
史上最强赘婿|沉默的糕点|穿越异世成为财主家的小白脸赘婿，因太废物被赶出来。于是他发奋图强，找一个更有权有势绝美高贵的豪门千金做了上门女婿。练武是不可能练武的，这辈子都不可能练武，只能靠吃软饭才能维持生活！我要把老婆培养成天下第..
史上最牛掌门系统|菩提树下|“掌门，不好啦，一群隐世强者杀上来了，他们说要为自己的宗门报仇。”“全部杀了，正好我的绝世杀神称号还差几个人头。”“掌门，不好啦，一群避世神兽杀上来了，他们说要自己的子孙报仇。”“来的好，全部炖了，正好今天吃神..
儒道至圣|永恒之火|这是一个读书人掌握天地之力的世界。才气在身，诗可杀敌，词能灭军，文章安天下。秀才提笔，纸上谈兵；举人杀敌，出口成章；进士一怒，唇枪舌剑。圣人驾临，口诛笔伐，可诛人，可判天子无道，以一敌国。此时，圣院把持文位，国君掌官位，十..
神奇道具师|道三生|传说，有一个神奇的人，行走在无限世界，用无数神奇的道具与人交换奇珍异宝，大家都称呼其为：神奇道具师....
大夏王侯|一夕烟雨|永夜降世，妖魔四起，百年暗夜到来之际，夏宫里走来了一位腼腆的少年郎....
修炼狂潮|傅啸尘|这是一个科学与武道并重的时代，大灾变之后，人类发现了超古代修炼文明，开启了一个大修炼时代，并开始了昆仑界的殖民之路！这是一个人类危机重重，同时也是一个热血沸腾的，强者辈出的时代！得到了超古代文明强者丹皇传承以..
放开那个女巫|二目|程岩原以为穿越到了欧洲中世纪，成为了一位光荣的王子。但这世界似乎跟自己想的不太一样？女巫真实存在，而且还真具有魔力？女巫种田文，将种田进行到底。标签：种田文..
绝品隐忍系统|南归|六次表白被拒绝，李峰意外获得隐忍系统。爆炸武力值，碾压神榜十大强者，睥睨世界！超强魅力值，绝色美女一个个投怀送抱……无敌幸运值，随便挖一个坑，都可以发现远古宝藏！一段最牛逼霸道的妖孽人生，一个世界之王的成长故事..
最强天眼皇帝|寒食西风|龙轩带着极品天眼系统，穿越到了秦国太子身上，开局一只眼，宝贝全靠捡：“叮！地下埋着一把极品狂雷大宝剑，宿主快快挖取！”“叮！此书乃是九品上等武技的残品，待本天眼帮你完善！”“叮！空气中出现了‘天眼礼包’，可抽取各种宝..
绝天神帝|香辣卷筒粉|一代神王被师傅与挚爱欺骗暗算，陨落于天阴魔谷。重生为大乾国本是天才，却被人害得修为尽散的落魄皇子，面对从天堂跌落地狱的人情冷暖……朱申淡然以对，他重修神道，强势崛起！三头六臂，镇压十方！成就绝天神帝！..
无疆|小刀锋利|鹰击长空，鱼跃龙门，熊咆虎啸，万物皆有灵。末法之极，磁极轮转，世界变迁。曾经那个熟悉的世界，已经变得面目全非。当神话变成现实，当传说不再神秘，世界无疆，热血永恒..
万龙神尊|晓未央|那前方尸骨如山，血似海流，而他从长生中来，无路可走，唯九死一生....作品标签： 热血、杀手、系统流、位面..
神藏|打眼|一念之间，沧海桑田。打眼带你进入古玩的世界！！！重生过去、畅想未来、梦幻现实，再塑传奇人生！！！..
超级仙农|鱼北北|种瓜得瓜种豆得豆，种下妹子呢？觉醒前世记忆，穷苦少年从此走上人生巅峰。种菜炼药、治病救人、开农庄做庄主……当混血校花、霸道警花、性感女老师、温柔小姐姐、软萌小厨娘、影视歌三栖小花旦环绕时，洛尘懵了。你..
最强小仙医|望川秋草|夏小猛山上挑水，发现小尼姑被欺负，上去搭救被推下山崖，却意外获得了五行灵诀 ，从此小农民大翻身，运用五行之术，在小乡村疯狂崛起...
逆天至尊|枯崖雨墓|昔日威震诸天神域，万世轮回后惨遭灭门！残酷的诅咒，万世的仇恨，谭云立志，不再沉沦！为了挚爱、亲人，从此一步步踩着仇人的尸体超越巅峰！逆天杀戮，纵横万界，唯我至尊！..
无限升级之恶魔皇帝|咸鱼也疯狂|落魄皇子秦枫身怀恶魔系统，借助恶魔之力，强化血脉，强化武学，强化天地法则！甚至强化“大兄弟”……开启契约魔宠，召唤诸天万界死去的大能英灵！女娲一念灭世间生灵，哮天犬一吼镇压八方妖神，诸葛亮统帅千军万马征战仙界…..
机破星河|当年离歌|梦想是……有实力的人才能谈论的现实。这是一个天才辈出的时代！这是一个英杰遍地的时代！贵族与平民的激烈冲突，联邦与帝国的明争暗斗，蠢蠢欲动的域外……当真理就在战舰巨炮射程之内，秩序无处宣章之际。沐凡携着神..
三界迅雷资源群|琅琊一号|天地人三界，仙妖魔共存！一机在手，天下我有，抢尽各路妖魔神仙宝贝！仙子，求别怕！不抢你！就请你一起赏风花雪月……不答应，信不信我抢的你连内内都不会留下！！！一部变异的24K钛合金手机！一个神奇的资源群！一款逆天的迅雷软件！命..
永夜君王|烟雨江南|千夜自困苦中崛起，在背叛中坠落。 自此一个人，一把枪，行在永夜与黎明之间，却走出一段传奇。 若永夜注定是他的命运，那他也要成为主宰的王....作品标签：千夜 古武 枪械 血族..
仙路至尊|睡秋|仙路通长生，至尊能逍遥，当长生不再逍遥，众生皆为囚徒，于是阴谋丛生，内乱迭起，外族入侵....在这样一个世界当中，有这样一位少年，他逆流而上，踏血而行，斗枭雄，灭诸王，于百族之中横行无忌，杀出一条通往至尊宝座的长生仙路！仙路..
万域之王|逆苍天|太古时代，有擎天巨灵，身如星辰，翱翔宙宇。有身怀异血的各族大尊，破灭虚空，再造天地，有古炼气士，远渡星河，教化众生。不知因何原因，一个时代悄然终结，万域隔绝，太古巨擎一一销声匿迹。时隔多年，少年聂天，通过一滴鲜血，重回太..
五行天|方想|万界融合，灵力消散，历经百万年的修真世界轰然崩塌，蛮荒大举入侵，五行天成为修真者最后的防线。千年之后，来自旧土的卑微少年，以苦力之身，深入蛮荒三年，破格获得进入五行天深造的机会。渴望掌握命运而一心追求变强的少..
狂徒弃少|傲剑问天|一次意外给了方墨一次新生的机会，本想低调的活着，默默的修炼，情与义却始终徘徊在他的左右，也正因重情重义，机缘一次次落在他的头上。他狂，是因为被迫如此，他强，是经历过重重危机后上天的恩赐！天道之下，他又演绎了怎样的..
神骨镇天|星河一梦|九天十地，灵骨为尊，我有神骨，可镇天下。唐玉获得了超越全天下修炼者的黄金圣骨，此后，逆天秘药、毁天神器、无敌阵法、统统触手可及...
十方神王|贪睡的龙|十方天域，强者为尊，少年林天偶获神秘铁剑，炼无上武道，修阵术神法，战万族天骄而不败！七尺剑芒荡八荒，十方天内，我为至尊神王！..
神级风水师|易象|气，乘风则散，界水则止。古人聚之使不散，行之使有止，故谓之风水！二十年寒暑，霉运一朝至，事业尽毁，女友劈腿，连最疼爱他的爷爷也离开了他！一块祖传木牌，内含祖传天师秘传，上可辨周天阴阳之气，下可预旦夕祸福凶吉！且看叶川掌控..
超神妖孽|江湖再见|这是一个被镇压万载的贱神。这是一个脸皮厚如城墙，谁惹谁倒霉的怪物。这是一个卷入世俗纷争，又担负起重塑神界使命的救世主。他叫云飞扬，一个无耻之徒，一个超神妖孽！“拜托，我只想和妹纸谈谈人生，能不能把拯救世界的..
帝问九天|啤酒老爹|叶不归，机缘巧合下进入女子宗门，从此一发不可收拾，踏上仙路，鏖战神体。任他天高地远，我自一拳轰平。任什么远古秘闻，一拳下去轰成历史尘埃。任他红粉骷髅……呀呀，我还没打呢，别往我身上扑..
最强妖孽|厄夜怪客|当其他人盲目的追寻真相的时候，记住万物皆虚。当其他的人被道德和法律所束缚，记住万事皆允。我们行走于黑暗，服务于光明。我是徐阳逸，我是……斩妖者..
最后一个使徒|卷土|黄沙掩埋了白骨，夕阳下的风中，有着血腥的味道。大陆的痛楚，在朝着四面八方扩散，当大爆炸的历史出现拐点的时候，当巨大的钢铁要塞横亘而过，遮蔽住人们视野的时候，当使徒的阴谋悄然深入到了每个人生活中的时候。和平即..
万古帝尊|南宫凌|这是一个前所未有的混乱大世，刀风血雨，快意恩仇，杀伐凌厉，血染青天。有南疆万族出世，有异度世界入侵，有中州皇族衰微，有三教九流林立，还有万古家族、无上圣教、黑暗势力``````争霸天下，伺机而动..
异世界的美食家|李鸿天|在武者举手可裂山川，甩腿可断长河的玄幻世界中，存在着这样一家小餐馆。小餐馆不大，但却是无数顶尖强者趋之若鹜之地。在那儿你可以品尝到用凤凰蛋和龙血米炒成的蛋炒饭。在那儿你可以喝到生命之泉配朱果酿制的烈..
逆天龙神|不若流浪|上古时期，龙族主宰天下，天地万族受尽了压迫。裂穹剑帝李玄道，为了摆脱龙族的统治，率领整个人类奋起反抗。就在他耗尽心血，将龙神斩于天玄山的时候，却被自己的兄弟和未婚妻联手偷袭杀死。转世重生，已经是五百年后，仇恨..
战神转世|苍狼笑月|沉眠三载，不知多少流言飞语，废材？天才！命运沉沦，走过多少世道艰辛，庸碌？强者！面对列强，迎难而上！唯我男儿本色。仗剑天涯，热血铸就！笑傲天地宇宙。修武道，踏九霄，眇苍穹。一个天才少年，得战神传承，改造体质，成逆天之资..
修真四万年|卧牛真人|“倘若这宇宙，真是一片残酷血腥的黑暗森林，我们修真者，也会燃烧自己的生命，绽放出微弱的火花！”“哪怕这火花再微弱，再短暂，再渺小，可是只要我们源源不断，前赴后继，终有一日，火花会点燃杂草，杂草会燎到灌木，灌木会蔓延大树..
七界武神|叶之凡|在这片浩瀚的大陆，武者便是金字塔顶端的生物，强大的武者可以粉碎天地，打破苍穹，战上九重天。而要想成为武者，就必须拥有武魂！叶天是一名华夏国的特种兵，穿越到了这个崇武的世界，凭着与生俱来天赋，他在十五岁时便达到了..
我意逍遥|飞之鸟|修行是为了什么？是为了权倾天下？是为了黄金满屋？是为了醉卧美人膝？沙凌摇摇头，他修行修的是心，修的是随意，为的是人生可以由自己把握，为的是流云闲鹤的飘逸洒脱，为的是常拂明镜不沾尘...且看一名普通男子如何偶得机缘，..
修仙算个什么事|羽化虚空|一株不知名的花草，不知道什么时候开了灵智，聆听了三千万年的经，也没有化成人形，同她一处的兄弟姐妹们早就飞升大道，而她还是一点变化没有。一日，神帝路过此处，也忍不住叹息，轻轻一挥手，让她下凡自修去了。一觉醒来，乐小..
万界天尊|血红|天为何物？高高在上，威严莫测，是法则，是戒律，是无情，是冷酷。天意，何也？俯瞰众生，操持风云，褫夺赏罚，随性而为。故，天意不可测，苍天不可近。顺之应之，未必得其利；逆之叛之，福祸却难定。天，禁锢万物如深井，红尘众生如烂泥..
大逆之门|知白|我念为天意，我怒为天威。第一章 幼兽 沧蛮山位于燕国北疆，和幽国接壤之处。这地方没人管没人要，山势又险恶，所以实打实的恶人出没之地。燕国，幽国，霸国，涿国...这不过数千里方圆的地盘上有十六个小国，被称之为幽燕十..
九重幻|讨厌夏天|做不到科学修仙，还做不到畅快修仙？我有凌云梦，直上九重天。内容标签：仙侠修真、女强、爽文、升级流。主角：胡寒珊..
紫炎天帝|想念那个夏天|龙羽，现代百年武学世家的传人离奇穿越，进入了一个追寻武道仙道至高领域的奇异世界。虽然出身显赫，却毫无地位，步步杀机。绝美的当朝公主，灵巧调皮的商贾巨富小姐，温柔善良的未婚妻子，专情的龙羽却被多情包围，且看龙羽..
紫荆令|新版红双喜|天地有正气，杂然赋流形。下则为河岳，上则为日星。于人曰浩然，沛乎塞苍冥。心存正气，无地域之别、无性别之分、无身份之差。他叫南锋，从死人堆里爬出来再次重生。放荡不羁，却不失真理随行，用行动为己开辟不同之路，用能..
鸿蒙神王|天空光明|鸿蒙开天大道规，日月星光梦幻天。大梦一醒谁先觉，直叹梦境逍遥天。陈逸奇遇获梦源道晶，开启以梦证道之路，大梦、虚幻、现实，又有谁能佐证，唯有行路之人才能看透一切，一觉心头皇者之路，征伐诸天万界之至尊..
重生之校园修仙|龙帝本尊|从仙界修仙回来地球重回十七岁的吴庸，决定要改写在地球上那二十年充满羞辱的命运，第一件事情，竟然是要和校花合租？！于是吴庸邪恶地想起了要不要与校花一块修仙...
超级黑锅系统|永恒Y|自从得知背黑锅能换来超级神器，林浩就把节操丢进了风里，可他的运气却变得逆天起来。冒充偷肚兜的小贼，反受到女神青睐；冒充成杀人凶手，反而成了替天行道的侠客；冒充成天才，一不小心真成了万中无一的绝世天才！积分兑宝..
九界仙尊|神出古异|他曾是仙门弃徒，遭人陷害，千年后重生醒来，凭不灭神魂，盖世神功，令八方风云乱，夺天地造化，掌生死之权，叱咤九境，昔日诸神为惧……关键词：玄幻仙侠、剧情流、悬念重重..
参天|风御九秋|天书残卷的出现，引起了世人疯狂的争夺，是机缘造化，还是暗藏玄机，修行，难道只是为了求得长生？..
神级猎杀者|萧雨客|圣人对弈的游戏，无限杀戮的空间，炼绿巨人为第二元神，收齐天大圣为衣钵传人，驭三国英雄、梁山好汉为将，统魔兽各族、星战舰队、变形金刚为兵，专杀穿越者！赵灵儿、凯兰崔尔、布尔玛、貂蝉、雅典娜、白素贞，群芳斗艳，后宫..
踏天无痕|更俗|大燕帝国三十六王侯之族的姚氏宗子姚兴犯下大罪，修为被废，记忆抹除，流放到边陲投靠舅父，从天之骄子如日中天的云端跌落，沦为二流宗门太微宗最低级的道兵弟子，在一次意外中摔落山崖而死..
吞天记|风青阳|天规天条，由我制定。万千鬼神，听我调遣。亿万世人心中，我是普渡苍生的至尊帝仙。漫天仙佛眼中，我是吞噬天地的盖世妖魔。而今天道不再，我且执掌众生..
龙符|梦入神机|苍茫大地，未来变革，混乱之中，龙蛇并起，谁是真龙，谁又是蟒蛇？或是天地众生，皆可成龙？朝廷，江湖门派，世外仙道，千年世家，蛮族，魔神，妖族，上古巫道，千百势力，相互纠缠，因缘际会..
校园修仙狂少|炎哥|姓名：丁毅。外号：丁抢抢。爱好：专治各种不服。“我是东宁丁毅，我喜欢以德服人，你千万不要逼我，因为我狂起来，连我自己都害怕。”..
丹符至尊|宝号|一粒丹，开万世仙途； 一张符，镇古今无敌； 仙、魔、鬼、人，粉墨登场，演四界恢弘。真域争霸，儒、道、佛、玄四家演义，看北辰带领玄门制霸真域。人为魔，诸天万界，皆可葬灭，打他个天地陆沉，万灵寂灭又何妨！魔做人，天地玄黄，宇宙洪..
我欲为仙|清晨公子|圣者以脊梁撑起天地，王者以伟岸镇压一切，霸者以血腥铸就王座。燕逸尘，自清风城而出，踏帝路，修长生，抗帝族，败天骄，杀到世上无人敢称尊！待繁华落尽，天地寂灭，放眼天下，谁人称雄？天上地下，唯我独尊。长生路上谁称王？唯我只手舞..
天工|沙包|顶尖文物修复师苏进，重生在了一个新的世界。故宫变成了古玩街，乐山大佛垮了一半，敦煌壁画被风沙侵蚀，莫高窟变成了无头窟。文物破损，修复技术流失。 人们需要历史，人们没有历史……苏进，是为改变这个世界而来的……..
都市最强修仙|单王张|“我重生了？”“还能修仙？”那么...故事便开始了。装高端的逼，打敌人的脸，泡绝色妹子，哦不，也可能是被妹子泡哦！..
生死丹尊|偏旁部首|唐明阳，一个逐出家族的纨绔废物，却意外觉醒前世生死丹尊的记忆，从此他的人生开始张狂肆意。世家天才，辱他欺他？踩踩踩！妖女圣女，芳华绝代？收收收！老祖老怪，看他不顺？杀杀杀！在这个强者为尊，弱者为蝼蚁，看你不顺眼，即可来杀你..
诸天万界|虾米XL|诸天万界，百家林立！叛逆少年化身史上最强弟子，修道家降妖除魔，练兵家神兵战阵，学儒道浩然正气；一符降至强鬼神，一刀斩山河日月，一阵困万古龙神，运筹帷幄化万千兵马；诸天神圣尽在脚下，万恶俯首，众神至尊！..
道神|凌乱的小道|剑道天才，手执一剑杀上九重天，大闹紫薇圣地，却被绝世强者镇压在神剑山下，日日夜夜饱受万剑穿心之苦！转世为逍遥王世子，却因体内无数剑气导致身体羸弱不堪，尔后修炼绝世功法蛮荒诛仙劲，自此一发不可收拾，踏上了逆天之旅..
剑王传说|失落叶|天心中州起天风，四海英豪逐白鹿。乱世中，一位少年人王手持神剑，踏万古天路，诛诸天邪魔，铸一段剑王传说！..
火帝神尊|西门飘血|离火燎天，帝镇苍穹。曾经的盖世帝尊重生在懵懂少年的的体内，开启全新的逆袭霸世的爽快传奇。2016纵横第一热血搞笑玄幻爽文恭请大伙品鉴！西门在此友情提示： 此文请不要在晚上临睡之前打开，因为很可能等你回过神来..
八荒剑神|云泪天雨|星辰演化大道，日月繁衍规则。强者无敌于世，夺天地之造化。叶晨风身负神秘金色血液，融合噬神之脑，继承恒古不朽意志，一念万骨枯，一剑沧海平，一人一剑横扫天地八荒，气凌万古苍穹，成就八荒剑神！..
皇道|雾外江山|雄关漫道真如铁，而今迈步从头越！皇道天帝，霸绝乾坤！灭诸神，斩至尊！修最强功法，得最靓女神！神国废墟掠重宝，绝色天香伴君行！穿梭时空，英雄谁属？唯我皇道至尊！..
异界霸主在都市|悄悄的躲起来|见过穿越异界凭金手指称王称霸的，但那异界霸主穿越都市巧遇金手指开始成就非凡人生的你见过嘛？只有想不到没有做不到，至于简介？看文便知道！ 第一章 天武大陆，风雷山顶！此时人山人海，大家都在等待着一个人的到来！凌逸云..
魔域|乱世狂刀|一朝英雄拔剑起，又是苍生十年劫。但那世间最风流的繁华，却又怎么抵得上你眉间一点朱砂……第1章 “我居然穿越了？”雷诺躺在硬石板床上，看着黑乎乎的陌生碎石屋顶，久久都无法相信已经发生的一切。前世的他，是一名大..
仙侠世界|无罪|当踏上修仙之路，万千仙道在前，而你只是如蝼蚁般存在，当万般欺凌，无数不平落于你身，你是该隐忍，还是该奋起而争，不惧生死？第一章 晋国的东边，靠近无尽之海的地方，一道剑光犹如笔直的险峰冲天而起，直破云霄，淡淡的银色剑芒..
再踏浊苍路|大命运者|浊苍之路尚未走完，我又怎可倒下？！在那最灰暗的地方，有一个光点，不停闪耀，是指引，也是存活的依靠。而我永远不会满足于现在的成就，因为我知道，我可以变得更加优秀！标签：修仙 暧昧 玄幻..
九天帝尊|娶猫的老鼠|一心只想做个败家子的秦歌，机缘巧合得到神秘金钟，借助金钟力量弥补自身缺陷，从而踏上了逆天修炼之路。不过秦歌死性不改，誓要将败家大业进行到底。凡是奉承讨好他的，赏，赏，赏！凡是比他有钱还嚣张的，抢！抢！抢！凡是天材地宝..
（西幻）大魔王的深夜食谱|魇客|如果有一天醒过来，突然发现被五花大绑、团成一个球端上了魔王的餐桌怎么办？史莱姆：看我柔软的身段，我躲，我躲，我再躲……你插不中我啊哈哈！（被水晶碗罩住）小恶魔：大王，我身上的肉真的塞您牙缝都不够啊。（汪地一声哭了）元素..
御天神帝|乱世狂刀|大千世界，界域三千。人族少年名青羽，自雪国出，威御诸天！序言·守墓的少年 “小羽，不要哭，人终有一死，我和你娘的日子到了，老伙计们在星辰的怀抱之中等着我们呢！”“呵呵，比起那些已经提前走了的伙计们，能亲眼看着你，一天..
修者至尊|星痕絶|修真者们，修真的时候，一直都不怎么注重自己的心境修炼。林正乐，一个半路入道修真的少年，没有别人的指点，就靠着师父留下的神殿，他边探索边成长，最终成为一个超越神魔的存在！他是怎么成长的？本书慢慢地为你揭晓！！！..
